8 8
........
..xxx.g.
....xx..
xx..xxx.
........
....x...
.s..x...
........

